111111111111111111111111111
1E0000000000000C00000C00001
101001010010000010100100101
1P1001001010101000100100101
100110000C000000010000000C1
100010100000000010001000011
1010010010C000100000100C001
101000C10001000C001000000C1
111111111111111111111111111